111111111
10P00C001
100CCC001
10E000001
111111111