111111111
10P01C001
100CC1001
10E000001
111111111