1111111111111111111111111111111111111
1C000000000000000000000000000000000C1
1000000000000111111101111111111111111
1000000F0011111111C001111000111111111
100000001111111PC00001F00C00111111111
1000011111111C000000000000001111111E1
1001111111C00000000000000111111110001
10111111C00F0000000000011111110000001
101111CCCCCCCFCCCCCC01111111FF0000001
1011111111111111111101111111000F01111
10111111111111111111011111110FF111111
100F00000F000111111101111111011111111
100CF0000000011111110000000000F000001
100000F0000C011111110000000C000000001
1111111111111111111111111111111111111