111111111
10P01C0F1
100CC1001
10E000001
111111111