1111111111111
10010000000C1
1000011111001
1P0P110E00E01
1111111111111
1011011111111
1111111111111