1111111111111111111111111111111111111
1FPF1C001C0FF1000000F1C110000000011E1
1F0CC10011000000C000FF0111C011F100101
100F000F11111000F00FCF0111101FFF10001
1CF000000001111111000001000011F111111
11100000F0F000CF10C000010000001000C01
1111111110000000C000000001F0F00000001
1111FC0000X0000F1000000FCFC0100000001
1111111111111111111111111111111111111