111111111111111111111111
10P01C001C00010000F001C1
100CC100110F0000C0000001
100F0000111110000000C001
100000000001111111000001
11100000000000C010C00001
1111111110000000C0000F01
10000C000000000010000CE1
111111111111111111111111