11111111111
1P0000CF001
100000F00E1
100000FC001
11111111111